111111
100E01
100C01
100P01
111111
