110111
000000
110111
100001
111111
